1111111111111
100000PEC11C1
1111111111111