111111111111111111111111111111111111111111111111111111111111111111111111111111
100000E0C11C110000000000001000000000000100000000000010000000000001000000000001
100000000000000000000000000000000000000000000C000000000000000000000000000000P1
111111111111111111111111111111111111111111111111111111111111111111111111111111