111111111111111111111111111111111111111111111111111111111111111111111111111111
1000P000C11C110000000000001000000000000100000000000010000000000001000000000001
100000000000000000000000000000000000000000000C000000000000000000000000000000E1
100000000000000000000000000000000000000000000C00000000000000000000000000000001
100000000000000000000000000000000000000000000C00000000000000000000000000000001
100000000000000000000000000000000000000000000C00000000000000000000000000000001
100000000000000000000000000000000000000000000C00000000000000000000000000000001
100000000000000000000000000000000000000000000C00000000000000000000000000000001
100000000000000000000000000000000000000000000C00000000000000000000000000000001
100000000000000000000000000000000000000000000C00000000000000000000000000000001
100000000000000000000000000000000000000000000C00000000000000000000000000000001
100000000000000000000000000000000000000000000C00000000000000000000000000000001
100000000000000000000000000000000000000000000C00000000000000000000000000000001
100000000000000000000000000000000000000000000C00000000000000000000000000000001
100000000000000000000000000000000000000000000C00000000000000000000000000000001
100000000000000000000000000000000000000000000C00000000000000000000000000000001
100000000000000000000000000000000000000000000C00000000000000000000000000000001
100000000000000000000000000000000000000000000C00000000000000000000000000000001
100000000000000000000000000000000000000000000C00000000000000000000000000000001
100000000000000000000000000000000000000000000C00000000000000000000000000000001
100000000000000000000000000000000000000000000C00000000000000000000000000000001
100000000000000000000000000000000000000000000C00000000000000000000000000000001
100000000000000000000000000000000000000000000C00000000000000000000000000000001
100000000000000000000000000000000000000000000C00000000000000000000000000000001
100000000000000000000000000000000000000000000C00000000000000000000000000000001
100000000000000000000000000000000000000000000C00000000000000000000000000000001
100000000000000000000000000000000000000000000C00000000000000000000000000000001
100000000000000000000000000000000000000000000C00000000000000000000000000000001
100000000000000000000000000000000000000000000C00000000000000000000000000000001
100000000000000000000000000000000000000000000C00000000000000000000000000000001
100000000000000000000000000000000000000000000C00000000000000000000000000000001
100000000000000000000000000000000000000000000C00000000000000000000000000000001
100000000000000000000000000000000000000000000C00000000000000000000000000000001
100000000000000000000000000000000000000000000C00000000000000000000000000000001
100000000000000000000000000000000000000000000C00000000000000000000000000000001
100000000000000000000000000000000000000000000C00000000000000000000000000000001
100000000000000000000000000000000000000000000C00000000000000000000000000000001
100000000000000000000000000000000000000000000C00000000000000000000000000000001
100000000000000000000000000000000000000000000C00000000000000000000000000000001
100000000000000000000000000000000000000000000C00000000000000000000000000000001
100000000000000000000000000000000000000000000C00000000000000000000000000000001
100000000000000000000000000000000000000000000C00000000000000000000000000000001
100000000000000000000000000000000000000000000C00000000000000000000000000000001
100000000000000000000000000000000000000000000C00000000000000000000000000000001
100000000000000000000000000000000000000000000C00000000000000000000000000000001
100000000000000000000000000000000000000000000C00000000000000000000000000000001
100000000000000000000000000000000000000000000C00000000000000000000000000000001
100000000000000000000000000000000000000000000C00000000000000000000000000000001
100000000000000000000000000000000000000000000C00000000000000000000000000000001
100000000000000000000000000000000000000000000C00000000000000000000000000000001
100000000000000000000000000000000000000000000C00000000000000000000000000000001
111111111111111111111111111111111111111111111111111111111111111111111111111111