1111111111111111111111111111111111
1ECCCCCCCCCCCCCC00000C000000000001
101CC101CC1CCCC0101CC1CCCCCC010101
101CC1CC1010101CC01CC1CCCCCCC10101
1P0000000C00C0000000000000000000C1
1111111111111111111111111111111111