111111111111111111111111111111111111111111111111111111111111111111111111111111
1C1000E0C11C110000000000001000000000000100000000000010000000000001000000000001
101000000000000000000000000000000000000000000C000000000000000000000000000000P1
111111111111111111111111111111111111111111111111111111111111111111111111111111