1111111111111111111111111111111111111111111111111111111
100000P0C11C1100000000001000000000100000000000010000001
100000000000000000000000000C0000000000000000000000000E1
1111111111111111111111111111111111111111111111111111111